. . . . . . . . . . . . . . . . . .
. . . . . . . . . . . . . . . . . .
. # # # # # . # # # # . # # # # # .
. # . . . . . . . . . . . . . . # .
. # . . . . . . . . . . . . . . # .
. # . . . . # # # # # # . . . . # .
. # . . . . # . . . . # . . . . # .
. . . . . . . . . . . . . . . . . .
. . . . . . . # . . # . . . . . . .
. . . . . . . . . . . . . . . . . .
. . . . . . . # . . # . . . . . . .
. . . . . . . . . . . . . . . . . .
. . . . . . # # . . # # . . . . . .
. # . . . . # . . . . # . . . . # .
. # . . . . . . # # . . . . . . # .
. # . . . . . . # # . . . . . . # .
. # . . . . # . . . . # . . . . # .
. . . . . . # # . . # # . . . . . .
. . . . . . . . . . . . . . . . . .
. . . . . . . # . . # . . . . . . .
. . . . . . . . . . . . . . . . . .
. . . . . . . # . . # . . . . . . .
. . . . . . . . . . . . . . . . . .
. # . . . . # . . . . # . . . . # .
. # . . . . # # # # # # . . . . # .
. # . . . . . . . . . . . . . . # .
. # . . . . . . . . . . . . . . # .
. # # # # # . # # # # . # # # # # .
. . . . . . . . . . . . . . . . . .
. . . . . . . . . . . . . . . . . .